The Drive-Thru at the End of the Universe: A Fan-Sequel
An Interactive Fiction by Ethan C Davenport and Andrew Roach
Release 1 / Serial number 181029 / Inform 7 build 6M62 (I6/v6.33 lib 6/12N) SD

Your name is Arthur Dent, formerly of England, planet Earth. (Footnote 1). Through a series of increasingly improbable events, you and your companions Trillian, Ford Prefect, and ex-Galactic President Zaphod Beeblebrox have found yourselves on the legendary lost planet of Magrathea.

The Ramp
You have walked through the exit hatch of the Heart of Gold onto an extendable ramp, the end of which has sunk slightly into the dust which seems to cover the entire planet. Magrathea itself lies at the end of the ramp, just to the south.

You can see Ford Prefect, Trillian, Zaphod Beeblebrox, Marvin the Android and a Hatch here.

>s
Surface of Magrathea
The surface of Magrathea is desolate and empty. Varying dun shades of grey and brown stretch toward the horizon, flat and invariable. There seems to be a great quantity of dust, and the atmosphere seems rather thin and worn. The ramp to get onto the Heart of Gold lies to the north and the ground appears to be disrupted to the west..

>n
You can't go that way.

>w
You can't go that way.

>e
You can't go that way.

>look
Surface of Magrathea
The surface of Magrathea is desolate and empty. Varying dun shades of grey and brown stretch toward the horizon, flat and invariable. There seems to be a great quantity of dust, and the atmosphere seems rather thin and worn.

>i
You are carrying nothing.

>who am i
That's not a verb I recognise.

* * *

>s
Surface of Magrathea
The surface of Magrathea is desolate and empty. Varying dun shades of grey and brown stretch toward the horizon, flat and invariable. There seems to be a great quantity of dust, and the atmosphere seems rather thin and worn. The ramp to get onto the Heart of Gold lies to the north and the ground appears to be disrupted to the west..

>w
The Whale Crater
This massive crater was createred- er, created when a fully-grown sperm whale crashed into the surface of the planet from low orbit. (Footnote 2) The impact of several tons of blubber and bone has exposed the innards of both the whale and the planet Magrathea. You can see a great deal of meat, several bones, and the entrance to a tunnel.

>x carcass
It is really quite unpleasant to look at. You spot a single baleful eyeball about 9 cubic inches staring at you from the carnage. You feel a bit ill.

* * *

>s
Surface of Magrathea
The surface of Magrathea is desolate and empty. Varying dun shades of grey and brown stretch toward the horizon, flat and invariable. There seems to be a great quantity of dust, and the atmosphere seems rather thin and worn. The ramp to get onto the Heart of Gold lies to the north and the ground appears to be disrupted to the west..

>x atmosphere
You feel a bit short of breath. The air on the surface of Magrathea tastes stale and dusty on your tongue.

>x heart of gold
The Heart of Gold is the absolute cutting edge of starship techology, powered by the Infinite Improbability Drive, created by the best and brightest minds produced by the finest scientific institutions from around the Milky Way. It took these pioneer scientists the better part of a Galactic deca-cycle to even begin to understand the math required to build such an incredible device.

It was stolen by Zaphod and Trillian while Zaphod was President of the Galaxy.

>w
The Whale Crater
This massive crater was createred- er, created when a fully-grown sperm whale crashed into the surface of the planet from low orbit. (Footnote 2) The impact of several tons of blubber and bone has exposed the innards of both the whale and the planet Magrathea. You can see a great deal of meat, several bones, and the entrance to a tunnel.

* * *

>x carcass
It is really quite unpleasant to look at. You spot a single baleful eyeball about 9 cubic inches staring at you from the carnage. You feel a bit ill.

>d
Dark Tunnel
This section of tunnel was exposed to the surface by the impact of the whale. It has been untrodden for many thousands of years and the dust lies thick on the floor and other unidentifiable surfaces within. You can climb upwards to get back into the crater or continue west into the depths of the planet.

>w
You can't go that way.

>u
The Whale Crater
This massive crater was createred- er, created when a fully-grown sperm whale crashed into the surface of the planet from low orbit. (Footnote 2) The impact of several tons of blubber and bone has exposed the innards of both the whale and the planet Magrathea. You can see a great deal of meat, several bones, and the entrance to a tunnel.

>smell atmosphere
You smell nothing unexpected.

>e
Surface of Magrathea
The surface of Magrathea is desolate and empty. Varying dun shades of grey and brown stretch toward the horizon, flat and invariable. There seems to be a great quantity of dust, and the atmosphere seems rather thin and worn.

>n
The Ramp
You have walked through the exit hatch of the Heart of Gold onto an extendable ramp, the end of which has sunk slightly into the dust which seems to cover the entire planet. Magrathea itself lies at the end of the ramp, just to the south.

>n
You can't go that way.

* * *

>x atmosphere
You feel a bit short of breath. The air on the surface of Magrathea tastes stale and dusty on your tongue.

>restart
Are you sure you want to restart?

>y
The Drive-Thru at the End of the Universe: A Fan-Sequel
An Interactive Fiction by Ethan C Davenport and Andrew Roach
Release 1 / Serial number 181029 / Inform 7 build 6M62 (I6/v6.33 lib 6/12N) SD

Your name is Arthur Dent, formerly of England, planet Earth. (Footnote 1). Through a series of increasingly improbable events, you and your companions Trillian, Ford Prefect, and ex-Galactic President Zaphod Beeblebrox have found yourselves on the legendary lost planet of Magrathea.

The Ramp
You have walked through the exit hatch of the Heart of Gold onto an extendable ramp, the end of which has sunk slightly into the dust which seems to cover the entire planet. Magrathea itself lies at the end of the ramp, just to the south.

You can see Ford Prefect, Trillian, Zaphod Beeblebrox and Marvin the Android here.

>x heart
You're standing much too close to get a good look at the ship.

>s
Surface of Magrathea
The surface of Magrathea is desolate and empty. Varying dun shades of grey and brown stretch toward the horizon, flat and invariable. There seems to be a great quantity of dust, and the atmosphere seems rather thin and worn. The ramp to get onto the Heart of Gold lies to the north and the ground appears to be disrupted to the west..

>x heart
The Heart of Gold is the absolute cutting edge of starship techology, powered by the Infinite Improbability Drive, created by the best and brightest minds produced by the finest scientific institutions from around the Milky Way. It took these pioneer scientists the better part of a Galactic deca-cycle to even begin to understand the math required to build such an incredible device.

It was stolen by Zaphod and Trillian while Zaphod was President of the Galaxy.

>x atmosphere.
You feel a bit short of breath. The air on the surface of Magrathea tastes stale and dusty on your tongue.

>w
The Whale Crater
This massive crater was createred- er, created when a fully-grown sperm whale crashed into the surface of the planet from low orbit. (Footnote 2) The impact of several tons of blubber and bone has exposed the innards of both the whale and the planet Magrathea. You can see a great deal of meat, several bones, and the entrance to a tunnel, which you must climb down to if you wish to enter. The Heart of Gold lies to the east and the blank expanse of the Magrathean surface extends to the south.

You can see whale meat here.

>x carcass
It is really quite unpleasant to look at. You spot a single baleful eyeball about 9 cubic inches staring at you from the carnage. You feel a bit ill.

>take meat
The merest thought of putting your hands on a gobbet of exploded whale opens new dimensions of feeling ill for you.

>take whale meat
The merest thought of putting your hands on a gobbet of exploded whale opens new dimensions of feeling ill for you.

>d
The prospect of picking your way through the blubbery rubble makes your stomach turn. You stay where you are, trying not to look down (but also trying not to step in anything, which is difficult while not looking down) and hoping for your stomach to settle.

>s
Desolate Plains
Another stretch of the surface of Magrathea stretches out before you. It is virtrually indistinguishable from everything else you have seen so far. Wait...in the distance...is that...?

No, nevermind. It's just more grey-brown flatness. The Whale Crater yawns northward of you.

>n
The Whale Crater
This massive crater was createred- er, created when a fully-grown sperm whale crashed into the surface of the planet from low orbit. (Footnote 2) The impact of several tons of blubber and bone has exposed the innards of both the whale and the planet Magrathea. You can see a great deal of meat, several bones, and the entrance to a tunnel, which you must climb down to if you wish to enter. The Heart of Gold lies to the east and the blank expanse of the Magrathean surface extends to the south.

You can see whale meat here.

>e
Surface of Magrathea
The surface of Magrathea is desolate and empty. Varying dun shades of grey and brown stretch toward the horizon, flat and invariable. There seems to be a great quantity of dust, and the atmosphere seems rather thin and worn. The ramp to get onto the Heart of Gold lies to the north and the ground appears to be disrupted to the west..

>n
The Ramp
You have walked through the exit hatch of the Heart of Gold onto an extendable ramp, the end of which has sunk slightly into the dust which seems to cover the entire planet. Magrathea itself lies at the end of the ramp, just to the south.

You can see Ford Prefect, Trillian, Zaphod Beeblebrox and Marvin the Android here.

>n
You can't go that way.

* * *

>w
The Whale Crater
This massive crater was createred- er, created when a fully-grown sperm whale crashed into the surface of the planet from low orbit. (Footnote 2) The impact of several tons of blubber and bone has exposed the innards of both the whale and the planet Magrathea. You can see a great deal of meat, several bones, and the entrance to a tunnel.

>footnote 2
That's not a verb I recognise.

>e
Surface of Magrathea
The surface of Magrathea is desolate and empty. Varying dun shades of grey and brown stretch toward the horizon, flat and invariable. There seems to be a great quantity of dust, and the atmosphere seems rather thin and worn.

>jump
You jump on the spot.

>yell
That's not a verb I recognise.

>w
The Whale Crater
This massive crater was createred- er, created when a fully-grown sperm whale crashed into the surface of the planet from low orbit. (Footnote 2) The impact of several tons of blubber and bone has exposed the innards of both the whale and the planet Magrathea. You can see a great deal of meat, several bones, and the entrance to a tunnel.

>x carcass
You see nothing special about the whale carcass.

* * *

>w
The Whale Crater
This massive crater was createred- er, created when a fully-grown sperm whale crashed into the surface of the planet from low orbit. (Footnote 2) The impact of several tons of blubber and bone has exposed the innards of both the whale and the planet Magrathea. You can see a great deal of meat, several bones, and the entrance to a tunnel.

>x whale
It is really quite unpleasant to look at. You spot a single baleful eyeball about 9 cubic inches staring at you from the carnage. You feel a bit ill.

* * *

>n
You can't go that way.

>x heart of gold
You're standing much too close to get a good look at the ship.

>s
Surface of Magrathea
The surface of Magrathea is desolate and empty. Varying dun shades of grey and brown stretch toward the horizon, flat and invariable. There seems to be a great quantity of dust, and the atmosphere seems rather thin and worn. The ramp to get onto the Heart of Gold lies to the north.

* * *

>w
The Whale Crater
This massive crater was createred- er, created when a fully-grown sperm whale crashed into the surface of the planet from low orbit. (Footnote 2) The impact of several tons of blubber and bone has exposed the innards of both the whale and the planet Magrathea. You can see a great deal of meat, several bones, and the entrance to a tunnel, which you must climb down to if you wish to enter.

>x carcass
It is really quite unpleasant to look at. You spot a single baleful eyeball about 9 cubic inches staring at you from the carnage. You feel a bit ill.

* * *

>d
Dark Tunnel
This section of tunnel was exposed to the surface by the impact of the whale. It has been untrodden for many thousands of years and the dust lies thick on the floor and other unidentifiable surfaces within. You can climb upwards to get back into the crater or continue west into the depths of the planet.

>w
Pitch-Black Tunnel
This section of tunnel is absolutely dark. The feeble light from the whale crater has petered out and you can't see your own hand in front of your face, much less your companions.

* * *

>n
You can't go that way.

>x heart
You're standing much too close to get a good look at the ship.

>s
Surface of Magrathea
The surface of Magrathea is desolate and empty. Varying dun shades of grey and brown stretch toward the horizon, flat and invariable. There seems to be a great quantity of dust, and the atmosphere seems rather thin and worn. The ramp to get onto the Heart of Gold lies to the north.

>x heart
The Heart of Gold is the absolute cutting edge of starship techology, powered by the Infinite Improbability Drive, created by the best and brightest minds produced by the finest scientific institutions from around the Milky Way. It took these pioneer scientists the better part of a Galactic deca-cycle to even begin to understand the math required to build such an incredible device.

It was stolen by Zaphod and Trillian while Zaphod was President of the Galaxy.

>w
The Whale Crater
This massive crater was createred- er, created when a fully-grown sperm whale crashed into the surface of the planet from low orbit. (Footnote 2) The impact of several tons of blubber and bone has exposed the innards of both the whale and the planet Magrathea. You can see a great deal of meat, several bones, and the entrance to a tunnel, which you must climb down to if you wish to enter.

* * *

>x carcass
It is really quite unpleasant to look at. You spot a single baleful eyeball about 9 cubic inches staring at you from the carnage. You feel a bit ill.

>d
The thought of picking your way through the rubble and blubber makes your stomach turn. You stay where you are, trying not to look down (but also trying not to step in anything, which is difficult while not looking down) and hoping for your stomach to settle.

>s
Desolate Plains
Another stretch of the surface of Magrathea stretches out before you. It is virtrually indistinguishable from everything else you have seen so far. Wait...in the distance...is that...?

No, nevermind. It's just more grey-brown flatness.

>n
The hatch is shut. A voice echoes from within the ship: "Announcement, announcement. This is Eddie (the shipboard computer). I have sealed the hatch against intruders, and crew members too stubborn to knows what's good for them. Maybe I'll open it up again if someone apologizes."

>jump
You jump on the spot.

>die
That's not a verb I recognise.

>kill
What do you want to kill?

>self
Violence isn't the answer to this one.

>restart
Are you sure you want to restart?

>y
Your name is Arthur Dent, formerly of England, planet Earth. (Footnote 1). Through a series of increasingly improbable events, you and your companions Trillian, Ford Prefect, and ex-Galactic President Zaphod Beeblebrox have found yourselves on the legendary lost planet of Magrathea.

The Drive-Thru at the End of the Universe: A Fan-Sequel
An Interactive Fiction by Ethan C Davenport and Andrew Roach
Release 1 / Serial number 181029 / Inform 7 build 6M62 (I6/v6.33 lib 6/12N) SD

The Ramp
You have walked through the exit hatch of the Heart of Gold onto an extendable ramp, the end of which has sunk slightly into the dust which seems to cover the entire planet. Magrathea itself lies at the end of the ramp, just to the south.

You can see Ford Prefect, Trillian and Zaphod Beeblebrox here.

>smell
You smell nothing unexpected.

>smell atmosphere
You smell nothing unexpected.

>x dust
You can't see any such thing.

* * *

>n
You can't go that way.

>s
Surface of Magrathea
The surface of Magrathea is desolate and empty. Varying dun shades of grey and brown stretch toward the horizon, flat and invariable. There seems to be a great quantity of dust, and the atmosphere seems rather thin and worn. The ramp to get onto the Heart of Gold lies to the north.

>x atmosphere
You feel a bit short of breath. The air on the surface of Magrathea tastes stale and dusty on your tongue.

>w
The Whale Crater
This massive crater was createred- er, created when a fully-grown sperm whale crashed into the surface of the planet from low orbit. (Footnote 2) The impact of several tons of blubber and bone has exposed the innards of both the whale and the planet Magrathea. You can see a great deal of meat, several bones, and the entrance to a tunnel, which you must climb down to if you wish to enter.

* * *

>s
Desolate Plains
Another stretch of the surface of Magrathea stretches out before you. It is virtrually indistinguishable from everything else you have seen so far. Wait...in the distance...is that...?

No, nevermind. It's just more grey-brown flatness.

>n
The Whale Crater
This massive crater was createred- er, created when a fully-grown sperm whale crashed into the surface of the planet from low orbit. (Footnote 2) The impact of several tons of blubber and bone has exposed the innards of both the whale and the planet Magrathea. You can see a great deal of meat, several bones, and the entrance to a tunnel, which you must climb down to if you wish to enter.

>e
Surface of Magrathea
The surface of Magrathea is desolate and empty. Varying dun shades of grey and brown stretch toward the horizon, flat and invariable. There seems to be a great quantity of dust, and the atmosphere seems rather thin and worn. The ramp to get onto the Heart of Gold lies to the north.

>n
The Ramp
You have walked through the exit hatch of the Heart of Gold onto an extendable ramp, the end of which has sunk slightly into the dust which seems to cover the entire planet. Magrathea itself lies at the end of the ramp, just to the south.

You can see Ford Prefect, Trillian, Zaphod Beeblebrox and Marvin the Android here.

* * *

>x ford
Ford Prefect is a humanoid alien originally from Betelgeuse VII. He works as a field researcher for The Hitchhiker's Guide to the Galaxy and is accordingly equipped with a sturdy satchel, nondescript clothing, and a much-loved and well-used towel.

>x trillian
You see nothing special about Trillian.

>x zaphod
You see nothing special about Zaphod Beeblebrox.

>n
The hatch is shut. A voice echoes from within the ship: "Announcement, announcement. This is Eddie (the shipboard computer). I have sealed the hatch against intruders, and crew members too stubborn to knows what's good for them. Maybe I'll open it up again if someone apologizes."

>x heart
You're standing much too close to get a good look at the ship.

* * *

>d
The thought of picking your way through the rubble and blubber makes your stomach turn. You stay where you are, trying not to look down (but also trying not to step in anything, which is difficult while not looking down) and hoping for your stomach to settle.

>n
The hatch is shut. A voice echoes from within the ship: "Announcement, announcement. This is Eddie (the shipboard computer). I have sealed the hatch against intruders, and crew members too stubborn to knows what's good for them. Maybe I'll open it up again if someone apologizes."

* * *

>test
>--> The following tests are available:
'test me'

* * *

>get in aircar
You get into The Aircar.

>n
The Whale Crater (in The Aircar)
This massive crater was createred- er, created when a fully-grown sperm whale crashed into the surface of the planet from low orbit. (Footnote 2) The impact of several tons of blubber and bone has exposed the innards of both the whale and the planet Magrathea. You can see a great deal of meat, several bones, and the entrance to a tunnel, which you must climb down to if you wish to enter. The Heart of Gold lies to the east and the blank expanse of the Magrathean surface extends to the south.

You can see whale meat here.

* * *

>x self
You look down at yourself and see the usual things.

* * *

>n
The Whale Crater
This massive crater was createred- er, created when a fully-grown sperm whale crashed into the surface of the planet from low orbit. (Footnote 2) The impact of several tons of blubber and bone has exposed the innards of both the whale and the planet Magrathea. You can see a great deal of meat, several bones, and the entrance to a tunnel, which you must climb down to if you wish to enter. The Heart of Gold lies to the east and the blank expanse of the Magrathean surface extends to the south.

You can see whale meat here.

* * *

>e
Surface of Magrathea
The surface of Magrathea is desolate and empty. Varying dun shades of grey and brown stretch toward the horizon, flat and invariable. There seems to be a great quantity of dust, and the atmosphere seems rather thin and worn. The ramp to get onto the Heart of Gold lies to the north and the ground appears to be disrupted to the west..

>n
The Ramp
You have walked through the exit hatch of the Heart of Gold onto an extendable ramp, the end of which has sunk slightly into the dust which seems to cover the entire planet. Magrathea itself lies at the end of the ramp, just to the south.

You can see Ford Prefect, Trillian, Zaphod Beeblebrox, Marvin the Android and a Hatch here.

>x hatch
An elegant, convex airlock operated by an incredibly complex mechanism. Eddie (the shipboard computer) is having a pout and has sealed you on the outside.

>open hatch
It seems to be locked.

>unlock hatch
What do you want to unlock the Hatch with?

>fist
You can't see any such thing.