The Drive-Thru at the End of the Universe: A Fan-Sequel
An Interactive Fiction by Ethan C Davenport and Andrew Roach
Release 1 / Serial number 181026 / Inform 7 build 6M62 (I6/v6.33 lib 6/12N) SD

Your name is Arthur Dent, formerly of England, planet Earth. (Footnote 1). Through a series of increasingly improbable events, you and your companions Trillian, Ford Prefect, and Zaphod Beeblebrox have found yourselves on the legendary lost planet of Magrathea.

The Ramp
You have walked through the exit hatch of the Heart of Gold onto an extendable ramp, the end of which has sunk slightly into the dust which seems to cover the entire planet. Magrathea itself lies at the end of the ramp, just to the south.

>s
Surface of Magrathea
The surface of Magrathea is desolate and empty. Varying dun shades of grey and brown stretch toward the horizon, flat and invariable. There seems to be a great quantity of dust, and the atmosphere seems rather thin and worn.

>n
You can't go that way.

>w
You can't go that way.

>e
You can't go that way.

>look
Surface of Magrathea
The surface of Magrathea is desolate and empty. Varying dun shades of grey and brown stretch toward the horizon, flat and invariable. There seems to be a great quantity of dust, and the atmosphere seems rather thin and worn.

>i
You are carrying nothing.

>who am i
That's not a verb I recognise.

* * *

>s
Surface of Magrathea
The surface of Magrathea is desolate and empty. Varying dun shades of grey and brown stretch toward the horizon, flat and invariable. There seems to be a great quantity of dust, and the atmosphere seems rather thin and worn.

>w
The Whale Crater
This massive crater was createred- er, created when a fully-grown sperm whale crashed into the surface of the planet from low orbit. (Footnote 2) The impact of several tons of blubber and bone has exposed the innards of both the whale and the planet Magrathea. You can see a great deal of meat, several bones, and the entrance to a tunnel.

>x carcass
It is really quite unpleasant to look at. You spot a single baleful eyeball about 9 cubic inches staring at you from the carnage. You feel a bit ill.

* * *

>s
Surface of Magrathea
The surface of Magrathea is desolate and empty. Varying dun shades of grey and brown stretch toward the horizon, flat and invariable. There seems to be a great quantity of dust, and the atmosphere seems rather thin and worn.

>x atmosphere
You feel a bit short of breath. The air on the surface of Magrathea tastes stale and dusty on your tongue.

>x heart of gold
The Heart of Gold is the absolute cutting edge of starship techology, powered by the Infinite Improbability Drive, created by the best and brightest minds produced by the finest scientific institutions from around the Milky Way. It took these pioneer scientists the better part of a Galactic deca-cycle to even begin to understand the math required to build such an incredible device.

It was stolen by Zaphod and Trillian while Zaphod was President of the Galaxy.

>w
The Whale Crater
This massive crater was createred- er, created when a fully-grown sperm whale crashed into the surface of the planet from low orbit. (Footnote 2) The impact of several tons of blubber and bone has exposed the innards of both the whale and the planet Magrathea. You can see a great deal of meat, several bones, and the entrance to a tunnel.

* * *

>x carcass
It is really quite unpleasant to look at. You spot a single baleful eyeball about 9 cubic inches staring at you from the carnage. You feel a bit ill.

>d
Dark Tunnel
This section of tunnel was exposed to the surface by the impact of the whale. It has been untrodden for many thousands of years and the dust lies thick on the floor and other unidentifiable surfaces within. You can climb upwards to get back into the crater or continue west into the depths of the planet.

>w
You can't go that way.

>u
The Whale Crater
This massive crater was createred- er, created when a fully-grown sperm whale crashed into the surface of the planet from low orbit. (Footnote 2) The impact of several tons of blubber and bone has exposed the innards of both the whale and the planet Magrathea. You can see a great deal of meat, several bones, and the entrance to a tunnel.

>smell atmosphere
You smell nothing unexpected.

>e
Surface of Magrathea
The surface of Magrathea is desolate and empty. Varying dun shades of grey and brown stretch toward the horizon, flat and invariable. There seems to be a great quantity of dust, and the atmosphere seems rather thin and worn.

>n
The Ramp
You have walked through the exit hatch of the Heart of Gold onto an extendable ramp, the end of which has sunk slightly into the dust which seems to cover the entire planet. Magrathea itself lies at the end of the ramp, just to the south.

>n
You can't go that way.

* * *

>w
The Whale Crater
This massive crater was createred- er, created when a fully-grown sperm whale crashed into the surface of the planet from low orbit. (Footnote 2) The impact of several tons of blubber and bone has exposed the innards of both the whale and the planet Magrathea. You can see a great deal of meat, several bones, and the entrance to a tunnel.

>footnote 2
That's not a verb I recognise.

>e
Surface of Magrathea
The surface of Magrathea is desolate and empty. Varying dun shades of grey and brown stretch toward the horizon, flat and invariable. There seems to be a great quantity of dust, and the atmosphere seems rather thin and worn.

>jump
You jump on the spot.

>yell
That's not a verb I recognise.

>w
The Whale Crater
This massive crater was createred- er, created when a fully-grown sperm whale crashed into the surface of the planet from low orbit. (Footnote 2) The impact of several tons of blubber and bone has exposed the innards of both the whale and the planet Magrathea. You can see a great deal of meat, several bones, and the entrance to a tunnel.

>x carcass
You see nothing special about the whale carcass.

* * *

>w
The Whale Crater
This massive crater was createred- er, created when a fully-grown sperm whale crashed into the surface of the planet from low orbit. (Footnote 2) The impact of several tons of blubber and bone has exposed the innards of both the whale and the planet Magrathea. You can see a great deal of meat, several bones, and the entrance to a tunnel.

>x whale
It is really quite unpleasant to look at. You spot a single baleful eyeball about 9 cubic inches staring at you from the carnage. You feel a bit ill.

* * *

>n
The hatch is shut. A voice echoes from within the ship: "Announcement, announcement. This is Eddie (the shipboard computer). I have sealed the hatch against intruders, and crew members too stubborn to knows what's good for them. Maybe I'll open it up again if someone apologizes."

>x heart of gold
You're standing much too close to get a good look at the ship.

>s
Surface of Magrathea
The surface of Magrathea is desolate and empty. Varying dun shades of grey and brown stretch toward the horizon, flat and invariable. There seems to be a great quantity of dust, and the atmosphere seems rather thin and worn. The ramp to get onto the Heart of Gold lies to the north.

* * *

>w
The Whale Crater
This massive crater was createred- er, created when a fully-grown sperm whale crashed into the surface of the planet from low orbit. (Footnote 2) The impact of several tons of blubber and bone has exposed the innards of both the whale and the planet Magrathea. You can see a great deal of meat, several bones, and the entrance to a tunnel, which you must climb down to if you wish to enter.

>x carcass
It is really quite unpleasant to look at. You spot a single baleful eyeball about 9 cubic inches staring at you from the carnage. You feel a bit ill.

* * *

>d
Dark Tunnel
This section of tunnel was exposed to the surface by the impact of the whale. It has been untrodden for many thousands of years and the dust lies thick on the floor and other unidentifiable surfaces within. You can climb upwards to get back into the crater or continue west into the depths of the planet.

>w
Pitch-Black Tunnel
This section of tunnel is absolutely dark. The feeble light from the whale crater has petered out and you can't see your own hand in front of your face, much less your companions.